6 13 31
###############################
#     *  x  # *  ** * *      *#
# # # #*#*# # #*# # # # # #*# #
#    * * ***  **     *    **  #
##*# # #    # # # # # # # # #*#
#b    6 #  * 5   **      *  **#
# # #*# # # # # #*#*#*#*# # # #
##  *      4 x*   * ** * 5    #
# # # # #*# # # # #   6  8    #
#b# *      3    *        7    #
# ### # # # # # # #          *#
#p  ***    3              6   #
###############################