2 13 31
###############################
#p * *2     b *  ** * *      *#
# # # # #*# # #*# # # # # #*# #
# #  * * *** **      *    **  #
# #*# # # # #1# #b#1# # # # #*#
#   1      *     **      *  **#
# # #*# # # # # #*#*#*#*# # # #
#   *        *  s* *x* *      #
# # # # #*# # # # # # #*# #*# #
#   ****         *1           #
# # # # # # # # # #*# # # # #*#
#  ** *   *    2              #
###############################