7 13 31
###############################
#p         *8           67    #
#     #########################
#         1            ff     #
#                      ff     #
#                      ff     #
#              x       ff     #
#                      fb     #
#                      fb     #
#               f b  b  b     #
#              f  ffff  b     #
#         sf   f              #
###############################