4 13 31
###############################
#p    * **    *   3   4       #
# # # #*# # # # # # # # # # # #
#   2  ** * *  *   * ** 3 *   #
# # # # # #*# # # # # # #*# # #
#*   * *  2 *b* *   **        #
# # # # # # # # # # # # # #*# #
#    *     *  4     *    **  3#
# #*# # #*#*#*#*# # #2# # #*# #
#        * 4 *2*    *   *     #
#*# # # # # # # # # # #*# # #*#
#x*    * **    ** ***     4   #
###############################