5 13 31
###############################
#p *  *3   5   *  ** * *     *#
# # # # #*# # #*# # # # # #*# #
#    * * ***  **  4  *    **  #
#b#*# # # # # # #b#3# # # # #*#
#     23   *   7 **      *  **#
# # #*# # # # # #*#*#*#*# # # #
#   *    4 8 *   * *x* *   4  #
# # # # #*# # # # # # #*# #*# #
#   ****   3     *2     8     #
# # # # # # # # # #*# # # # #*#
#  ** *5  *    2        6 7   #
###############################