3 13 31
###############################
#p   ** ** 1  *   2           #
# # # #*# # # # # # # # # # # #
#*    3** * *  *   * ** 3 *   #
# # # # # #*# # # # # # #*# # #
#*   *s* 3  *** * x **        #
# # # # # # # # # # # # # #*# #
#    *   2 *        *    **  3#
# #*# # #*#*#*#*# # #1# # #*# #
#        *   *2*    *   *     #
#*# # # # # # # # # # #*# # #*#
# *    * **    ** ***     4   #
###############################